Lab1
An Interactive Fiction by Ozcar Cayetano
Release 1 / Serial number 260408 / Inform 7 v10.1.2 / D

You are rushing down Washington Avenue, in your small car, because the Baby in the backseat is hysterically crying. You do not know what it wants but you decide to pull over at a busy intersection to try and make the rest of the 4 hour drive home barable.

Car
A beat up red sedan with no headlights, just stickers. Outside is a busy intersection.

You can see a Baby and a diaper bag (in which are diapers, a bottle, old fruit snacks and rash cream) here.

>Go Outside
The Intersection

>look
The Intersection

>examine self
A single mom who works two jobs...

* * *

Lab1
An Interactive Fiction by Ozcar Cayetano
Release 1 / Serial number 260408 / Inform 7 v10.1.2 / D

You are rushing down Washington Avenue, in your small car, because the Baby in the backseat is hysterically crying. You do not know what it wants but you decide to pull over at a busy intersection to try and make the rest of the 4 hour drive home barable.

Car
A beat up red sedan with no headlights, just stickers. Outside is a busy intersection.

You can see a Baby and a diaper bag (in which are diapers, a bottle, old fruit snacks and rash cream) here.

>RULES
Rules tracing now switched on. Type "rules off" to switch it off again, or "rules all" to include even rules which do not apply.

[Rule "parse command rule" applies.]

>x player
You can't see any such thing.

>x self
[Rule "declare everything initially unmentioned rule" applies.]
[Rule "generate action rule" applies.]
[Rule "announce items from multiple object lists rule" applies.]
[Rule "set pronouns from items from multiple object lists rule" applies.]
[Rule "before stage rule" applies.]
[Rule "before examining the player" applies.]
[Rule "basic visibility rule" applies.]
[Rule "can't act in the dark rule" applies.]
[Rule "basic accessibility rule" applies.]
[Rule "carrying requirements rule" applies.]
[Rule "instead stage rule" applies.]
[Rule "requested actions require persuasion rule" applies.]
[Rule "carry out requested actions rule" applies.]
[Rule "descend to specific action-processing rule" applies.]
[Rule "work out details of specific action rule" applies.]
[Rule "investigate player's awareness before action rule" applies.]
[Rule "player aware of his own actions rule" applies.]
[Rule "check stage rule" applies.]
[Rule "carry out stage rule" applies.]
[Rule "standard examining rule" applies.]
Your balance is $100.

[Rule "examine directions rule" applies.]
[Rule "examine containers rule" applies.]
[Rule "examine supporters rule" applies.]
[Rule "examine devices rule" applies.]
[Rule "examine undescribed things rule" applies.]
[Rule "after stage rule" applies.]
[Rule "investigate player's awareness after action rule" applies.]
[Rule "report stage rule" applies.]
[Rule "report other people examining rule" applies.]
[Rule "last specific action-processing rule" applies.]
[Rule "A first turn sequence rule" applies.]
[Rule "scene change machinery rule" applies.]
[Rule "every turn stage rule" applies.]
[Rule "timed events rule" applies.]
[Rule "advance time rule" applies.]
[Rule "update chronological records rule" applies.]
[Rule "A last turn sequence rule" applies.]
[Rule "scene change machinery rule" applies.]
[Rule "adjust light rule" applies.]
[Rule "note object acquisitions rule" applies.]
[Rule "notify score changes rule" applies.]
[Rule "parse command rule" applies.]

* * *

Lab1
An Interactive Fiction by Ozcar Cayetano
Release 1 / Serial number 260408 / Inform 7 v10.1.2 / D

You are rushing down Washington Avenue, in your small car, because the Baby in the backseat is hysterically crying. You do not know what it wants but you decide to pull over at a busy intersection to try and make the rest of the 4 hour drive home barable.

Car
A beat up red sedan with no headlights, just stickers. Outside is a busy intersection.

You can see a Baby and a diaper bag (in which are diapers, a bottle, old fruit snacks and rash cream) here.

>SHOWME bag of potato chips
bag of potato chips - thing
location: in the snack shelf in the Convenience Store
unlit, inedible, portable; singular-named, improper-named
description: none
initial appearance: none
printed name: "bag of potato chips"
printed plural name: none
indefinite article: none
list grouping key: none
price: 3

* * *

Lab1
An Interactive Fiction by Ozcar Cayetano
Release 1 / Serial number 260408 / Inform 7 v10.1.2 / D

You are rushing down Washington Avenue, in your small car, because the Baby in the backseat is hysterically crying. You do not know what it wants but you decide to pull over at a busy intersection to try and make the rest of the 4 hour drive home barable.

Car
A beat up red sedan with no headlights, just stickers. Outside is a busy intersection.

You can see a Baby and a diaper bag (in which are diapers, a bottle, old fruit snacks and rash cream) here.

>buy snacks
Nothing is on sale.

>buy
What do you want to buy?

>diapers
Nothing is on sale.

* * *

>buy snacks
Nothing is on sale.

>x baby
The Baby is drooling all over it's yellow-orange bib and swirling its hair into a spiral.

* * *

Lab1
An Interactive Fiction by Ozcar Cayetano
Release 1 / Serial number 260408 / Inform 7 v10.1.2 / D

You are rushing down Washington Avenue, in your small car, because the Baby in the backseat is hysterically crying. You do not know what it wants but you decide to pull over at a busy intersection to try and make the rest of the 4 hour drive home barable.

Car
A beat up red sedan with no headlights, just stickers. Outside is a busy intersection.

You can see a Baby and a diaper bag (in which are diapers, a bottle, old fruit snacks and rash cream) here.

>drive
That's not a verb I recognise.

>look
Car
A beat up red sedan with no headlights, just stickers. Outside is a busy intersection.

You can see a Baby and a diaper bag (in which are diapers, a bottle, old fruit snacks and rash cream) here.

>look
Car
A beat up red sedan with no headlights, just stickers. Outside is a busy intersection.

You can see a Baby and a diaper bag (in which are diapers, a bottle, old fruit snacks and rash cream) here.

I beg your pardon?

I beg your pardon?

>look
Car
A beat up red sedan with no headlights, just stickers. Outside is a busy intersection.

You can see a Baby and a diaper bag (in which are diapers, a bottle, old fruit snacks and rash cream) here.

>look
Car
A beat up red sedan with no headlights, just stickers. Outside is a busy intersection.

You can see a Baby and a diaper bag (in which are diapers, a bottle, old fruit snacks and rash cream) here.

    *** You drive home, the baby is still crying. ***

Would you like to RESTART, RESTORE a saved game, QUIT or UNDO the last command?

>look
Please give one of the answers above.

Would you like to RESTART, RESTORE a saved game, QUIT or UNDO the last command?

* * *

Lab1
An Interactive Fiction by Ozcar Cayetano
Release 1 / Serial number 260408 / Inform 7 v10.1.2 / D

You are rushing down Washington Avenue, in your small car, because the Baby in the backseat is hysterically crying. You do not know what it wants but you decide to pull over at a busy intersection to try and make the rest of the 4 hour drive home barable.

Car
A beat up red sedan with no headlights, just stickers. Outside is a busy intersection.

You can see a Baby and a diaper bag (in which are diapers, a bottle, old fruit snacks and rash cream) here.

>examine
What do you want to examine?

>baby
The Baby is drooling all over it's yellow-orange bib and swirling its hair into a spiral.

>take baby
I don't suppose the Baby would care for that.

>examine car
You can't see any such thing.

>examine car
You can't see any such thing.

>examine diaper bag
In the diaper bag are diapers, a bottle, old fruit snacks and rash cream.

* * *

Lab1
An Interactive Fiction by Ozcar Cayetano
Release 1 / Serial number 260408 / Inform 7 v10.1.2 / D

You are rushing down Washington Avenue, in your small car, because the Baby in the backseat is hysterically crying. You do not know what it wants but you decide to pull over at a busy intersection to try and make the rest of the 4 hour drive home barable.

Car
A beat up red sedan with no headlights, just stickers. Outside is a busy intersection.

You can see a Baby and a diaper bag (in which are diapers, a bottle, old fruit snacks and rash cream) here.

>examine baby
You see nothing special about the Baby.

>talk baby
That's not a verb I recognise.

>talk to baby
That's not a verb I recognise.

>take baby
I don't suppose the Baby would care for that.

* * *

Lab1
An Interactive Fiction by Ozcar Cayetano
Release 1 / Serial number 260408 / Inform 7 v10.1.2 / D

You are rushing down Washington Avenue, in your small car, because the Baby in the backseat is hysterically crying. You do not know what it wants but you decide to pull over at a busy intersection to try and make the rest of the 4 hour drive home barable.

Car
A beat up red sedan with no headlights, just stickers. Outside is a busy intersection.

You can see a Baby and a diaper bag (in which are diapers, a bottle, old fruit snacks and rash cream) here.

>examine car
You can't see any such thing.

* * *

Lab1
An Interactive Fiction by Ozcar Cayetano
Release 1 / Serial number 260408 / Inform 7 v10.1.2 / D

You are rushing down Washington Avenue, in your small car, because the Baby in the backseat is hysterically crying. You do not know what it wants but you decide to pull over at a busy intersection to try and make the rest of the 4 hour drive home barable.

Car
A beat up red sedan with no headlights, just stickers. Outside is a busy intersection.

You can see a Baby and a diaper bag (in which are diapers, a bottle, old fruit snacks and rash cream) here.

>exit
The Intersection
There is an Arcade to the west, a large Gas Station to the east and the Car in the Intersection.

>w
Arcade
Inside this arcade you see a prize counter, some games, and a ball pit. You can use your money to play games and win tickets. The tickets can be used to get prizes at the prize counter. There are exits in all directions to the Intersection.

You can see a prize counter (in which are a spinning top, a slinky, a rattle, a mini soccer game and crayons), a skeeball machine, a basketball hoop, a water gun game, a punching machine and a ball pit here.

>take rattle
You do not have enough tickets for the rattle.

>x rattle
You see nothing special about the rattle.

It is priced at $30.

* * *

Lab1
An Interactive Fiction by Ozcar Cayetano
Release 1 / Serial number 260408 / Inform 7 v10.1.2 / D

You are rushing down Washington Avenue, in your small car, because the Baby in the backseat is hysterically crying. You do not know what it wants but you decide to pull over at a busy intersection to try and make the rest of the 4 hour drive home barable.

Car
A beat up red sedan with no headlights, just stickers. Outside is a busy intersection.

You can see a Baby and a diaper bag (in which are diapers, a bottle, old fruit snacks and rash cream) here.

>go The Intersection
You can't see any such thing.

* * *

Lab1
An Interactive Fiction by Ozcar Cayetano
Release 1 / Serial number 260408 / Inform 7 v10.1.2 / D

You are rushing down Washington Avenue, in your small car, because the Baby in the backseat is hysterically crying. You do not know what it wants but you decide to pull over at a busy intersection to try and make the rest of the 4 hour drive home barable.

Car
A beat up red sedan with no headlights, just stickers. Outside is a busy intersection.

You can see a Baby and a diaper bag (in which are diapers, a bottle, old fruit snacks and rash cream) here.

>go outside
The Intersection

* * *

Lab1
An Interactive Fiction by Ozcar Cayetano
Release 1 / Serial number 260408 / Inform 7 v10.1.2 / D

You are rushing down Washington Avenue, in your small car, because the Baby in the backseat is hysterically crying. You do not know what it wants but you decide to pull over at a busy intersection to try and make the rest of the 4 hour drive home barable.

Car
A beat up red sedan with no headlights, just stickers. Outside is a busy intersection.

You can see a Baby and a diaper bag (in which are diapers, a bottle, old fruit snacks and rash cream) here.

>look
Car
A beat up red sedan with no headlights, just stickers. Outside is a busy intersection.

You can see a Baby and a diaper bag (in which are diapers, a bottle, old fruit snacks and rash cream) here.

>clear
What do you want to clear?

>baby
The Baby might not like that.

>clear bag
Nothing obvious happens.

>clear
What do you want to clear?

>bag
Nothing obvious happens.

* * *

>look
Car
A beat up red sedan with no headlights, just stickers. Outside is a busy intersection.

You can see a Baby and a diaper bag (in which are diapers, a bottle, old fruit snacks and rash cream) here.

>take baby
It's only going to slow you down, leave it here.

* * *

Lab1
An Interactive Fiction by Ozcar Cayetano
Release 1 / Serial number 260408 / Inform 7 v10.1.2 / D

You are rushing down Washington Avenue, in your small car, because the Baby in the backseat is hysterically crying. You do not know what it wants but you decide to pull over at a busy intersection to try and make the rest of the 4 hour drive home barable.

Car
A beat up red sedan with no headlights, just stickers. Outside is a busy intersection.

You can see a Baby and a diaper bag (in which are diapers, a bottle, old fruit snacks and rash cream) here.

>o
Sorry, that can't be corrected.

>out
The Intersection
There is an Arcade to the west, a large Gas Station to the east and the Car in the Intersection.

>e
Gas Station
It's empty. There are no cars. Just a Food Stand to the North and the Convenience Store to the East.

>n
Food Stand
An older man is on the other side of the stand.  There are a foods on the counter. 

You can see a counter (in which are a spicy mango, a hot dog and a coconut water) here.

>take mango
You put the spicy mango in your pockets.

>take dog
You put the hot dog in your pockets.

>take water
You put the coconut water in your pockets.

>look
Food Stand
An older man is on the other side of the stand.  There are no more new foods on the counter. To the south is the Gas Station.

You can see a counter (empty) here.

* * *

Lab1
An Interactive Fiction by Ozcar Cayetano
Release 1 / Serial number 260408 / Inform 7 v10.1.2 / D

You are rushing down Washington Avenue, in your small car, because the Baby in the backseat is hysterically crying. You do not know what it wants but you decide to pull over at a busy intersection to try and make the rest of the 4 hour drive home barable.

Car
A beat up red sedan with no headlights, just stickers. Outside is a busy intersection.

You can see a Baby and a diaper bag (in which are diapers, a bottle, old fruit snacks and rash cream) here.

>out
The Intersection
There is an Arcade to the west, a large Gas Station to the east and the Car in the Intersection.

>e
Gas Station
It's empty. There are no cars. Just a Food Stand to the North, the Convenience Store to the East, and the Intersection to the West.

>e
Convenience Store
The cashier seems occupied with someone on the phone. The actual store only has one shelf of snacks. To the west is the Gas Station.

You can see a snack shelf (in which are a bag of potato chips, a candy bar, an orange soda and milk) here.

>out
Gas Station
It's empty. There are no cars. Just a Food Stand to the North, the Convenience Store to the East, and the Intersection to the West.

>e
Convenience Store
The cashier seems occupied with someone on the phone. The actual store only has one shelf of snacks. To the west is the Gas Station.

You can see a snack shelf (in which are a bag of potato chips, a candy bar, an orange soda and milk) here.

>exit
Gas Station
It's empty. There are no cars. Just a Food Stand to the North, the Convenience Store to the East, and the Intersection to the West.

>exit
But you aren't in anything at the moment.

>n
Food Stand
An older man is on the other side of the stand.  There are foods on the rack. 

You can see a food rack (in which are a spicy mango, a hot dog and a coconut water) here.

>take spicy many
I only understood you as far as wanting to take the spicy mango.

>take spicy mango
You put the spicy mango in your pockets.

* * *

>e
Gas Station
It's empty. There are no cars. Just a Food Stand to the North, the Convenience Store to the East, and the Intersection to the West.

>n
Food Stand
An older man is on the other side of the stand.  There are no more new foods on the counter. To the south is the Gas Station.

You can see a counter (in which are a spicy mango, a hot dog and a coconut water) here.

* * *

>out
The Intersection
There is an Arcade to the west, a large Gas Station to the east and the Car in the Intersection.

>in
Car
A beat up red sedan with no headlights, just stickers. Outside is a busy intersection.

You can see a Baby and a diaper bag (in which are diapers, a bottle, old fruit snacks and rash cream) here.

>buy bottle
Nothing is on sale.

>out
The Intersection
There is an Arcade to the west, a large Gas Station to the east and the Car in the Intersection.

* * *

>e
Gas Station
It's empty. There are no cars. Just a Food Stand to the North and the Convenience Store to the East.

>e
Convenience Store
The cashier seems occupied with someone on the phone. The actual store only has one shelf of snacks. To the west is the Gas Station.

You can see a snack shelf (in which are a bag of potato chips, a candy bar, an orange soda and milk) here.

>buy bar
Nothing is on sale.

* * *

>in
Car
A beat up red sedan with no headlights, just stickers. Outside is a busy intersection.

You can see a Baby and a diaper bag (in which are diapers, a bottle, old fruit snacks and rash cream) here.

>x baby
The Baby is drooling all over it's yellow-orange bib and swirling its hair into a spiral.

>take snacks
You put old fruit snacks in your pockets.

>out
The Intersection
There is an Arcade to the west, a large Gas Station to the east and the Car in the Intersection.

* * *

>e
Convenience Store
The cashier seems occupied with someone on the phone. The actual store only has one shelf of snacks. To the west is the Gas Station.

You can see a snack shelf (in which are a bag of potato chips, a candy bar, an orange soda and milk) here.

>take chips
You paid $4.
You put the bag of potato chips in your pockets.

>x pot
You can't see any such thing.

I beg your pardon?

>rules
Rules tracing now switched on. Type "rules off" to switch it off again, or "rules all" to include even rules which do not apply.

[Rule "parse command rule" applies.]

>x self
[Rule "declare everything initially unmentioned rule" applies.]
[Rule "generate action rule" applies.]
[Rule "announce items from multiple object lists rule" applies.]
[Rule "set pronouns from items from multiple object lists rule" applies.]
[Rule "before stage rule" applies.]
[Rule "before examining the player" applies.]
[Rule "basic visibility rule" applies.]
[Rule "can't act in the dark rule" applies.]
[Rule "basic accessibility rule" applies.]
[Rule "carrying requirements rule" applies.]
[Rule "instead stage rule" applies.]
[Rule "requested actions require persuasion rule" applies.]
[Rule "carry out requested actions rule" applies.]
[Rule "descend to specific action-processing rule" applies.]
[Rule "work out details of specific action rule" applies.]
[Rule "investigate player's awareness before action rule" applies.]
[Rule "player aware of his own actions rule" applies.]
[Rule "check stage rule" applies.]
[Rule "carry out stage rule" applies.]
[Rule "standard examining rule" applies.]
Your balance is $96.

[Rule "examine directions rule" applies.]
[Rule "examine containers rule" applies.]
[Rule "examine supporters rule" applies.]
[Rule "examine devices rule" applies.]
[Rule "examine undescribed things rule" applies.]
[Rule "after stage rule" applies.]
[Rule "After examining something" applies.]
[Rule "A first turn sequence rule" applies.]
[Rule "scene change machinery rule" applies.]
[Rule "every turn stage rule" applies.]
[Rule "timed events rule" applies.]
[Rule "advance time rule" applies.]
[Rule "update chronological records rule" applies.]
[Rule "A last turn sequence rule" applies.]
[Rule "scene change machinery rule" applies.]
[Rule "adjust light rule" applies.]
[Rule "note object acquisitions rule" applies.]
[Rule "notify score changes rule" applies.]
[Rule "parse command rule" applies.]

* * *

>out
The Intersection
There is an Arcade to the west, a large Gas Station to the east and the Car in the Intersection.

>w
Arcade
Inside this arcade you see a prize counter, some games, and a ball pit. You can use your money to play games and win tickets. The tickets can be used to get prizes at the prize counter. There are exits in all directions to the Intersection.

You can see a prize counter (in which are a spinning top, a slinky, a rattle, a mini soccer game and crayons), a skeeball machine, a basketball hoop, a water gun game, a punching machine and a ball pit here.

>SHOWME skeeball machine
skeeball machine - thing
location: in the Arcade
unlit, inedible, fixed in place; singular-named, improper-named
description: "A game of skill, potential to gain upwards of 100 tickets. You are not very skilled. Costs $20 to play."
initial appearance: none
printed name: "skeeball machine"
printed plural name: none
indefinite article: none
list grouping key: none
price: 20

* * *

>w
Arcade
Inside this arcade you see a prize counter, some games, and a ball pit. You can use your money to play games and win tickets. The tickets can be used to get prizes at the prize counter. There are exits in all directions to the Intersection.

You can see a prize counter (in which are a spinning top, a slinky, a rattle, a mini soccer game and crayons), a skeeball machine, a basketball hoop, a water gun game, a punching machine and a ball pit here.

>out
The Intersection
There is an Arcade to the west, a large Gas Station to the east and the Car in the Intersection.

* * *

>w
Arcade
Inside this arcade you see a prize counter, some games, and a ball pit. You can use your money to play games and win tickets. The tickets can be used to get prizes at the prize counter. There are exits in all directions to the Intersection.

You can see a prize counter (in which are a spinning top, a slinky, a rattle, a mini soccer game and crayons), a skeeball machine, a basketball hoop, a water gun game, a punching machine and a ball pit here.

>s
The Intersection
There is an Arcade to the west, a large Gas Station to the east and the Car in the Intersection.

>out
But you aren't in anything at the moment.

>in
Car
A beat up red sedan with no headlights, just stickers. Outside is a busy intersection.

You can see a Baby and a diaper bag (in which are diapers, a bottle, old fruit snacks and rash cream) here.

>exit
The Intersection
There is an Arcade to the west, a large Gas Station to the east and the Car in the Intersection.

>enter
You must supply a noun.

>enter car
You can't see any such thing.

>exit
But you aren't in anything at the moment.

>enter arcade
You can't see any such thing.

>w
Arcade
Inside this arcade you see a prize counter, some games, and a ball pit. You can use your money to play games and win tickets. The tickets can be used to get prizes at the prize counter. There are exits in all directions to the Intersection.

You can see a prize counter (in which are a spinning top, a slinky, a rattle, a mini soccer game and crayons), a skeeball machine, a basketball hoop, a water gun game, a punching machine and a ball pit here.

>exit
The Intersection
There is an Arcade to the west, a large Gas Station to the east and the Car in the Intersection.

* * *

>w
Arcade
Inside this arcade you see a prize counter, some games, and a ball pit. You can use your money to play games and win tickets. The tickets can be used to get prizes at the prize counter. There are exits in all directions to the Intersection.

You can see a prize counter (in which are a spinning top, a slinky, a rattle, a mini soccer game and crayons), a skeeball machine, a basketball hoop, a water gun game, a punching machine and a ball pit here.

>play ball
You gave the attendant $1.
You now have $99.

>play ball
You gave the attendant $1.
You now have $98.

>play ball
You gave the attendant $1.
You now have $97.

You found treasure!
You gained $20! Woohoo!

>play ball
You gave the attendant $1.
You now have $116.

>play ball
You gave the attendant $1.
You now have $115.

>play ball
You gave the attendant $1.
You now have $114.

>play ball
You gave the attendant $1.
You now have $113.

>play ball
You gave the attendant $1.
You now have $112.

>play ball
You gave the attendant $1.
You now have $111.

You found treasure!
You gained $14! Woohoo!

>play ball
You gave the attendant $1.
You now have $124.

>play ball
You gave the attendant $1.
You now have $123.

>play ball
You gave the attendant $1.
You now have $122.

>play ball
You gave the attendant $1.
You now have $121.

You found treasure!
You gained $15! Woohoo!

>play ball
You gave the attendant $1.
You now have $135.

>play ball
You gave the attendant $1.
You now have $134.

>play ball
You gave the attendant $1.
You now have $133.

>play ball
You gave the attendant $1.
You now have $132.

You found treasure!
You gained $19! Woohoo!

>play ball
You gave the attendant $1.
You now have $150.

You found treasure!
You gained $5! Woohoo!

>play ball
You gave the attendant $1.
You now have $154.

>play ball
You gave the attendant $1.
You now have $153.

You found treasure!
You gained $18! Woohoo!

>play ball
You gave the attendant $1.
You now have $170.

>play ball
You gave the attendant $1.
You now have $169.

>play ball
You gave the attendant $1.
You now have $168.

>play ball
You gave the attendant $1.
You now have $167.

>play ball
You gave the attendant $1.
You now have $166.

>play ball
You gave the attendant $1.
You now have $165.

>play ball
You gave the attendant $1.
You now have $164.

>play ball
You gave the attendant $1.
You now have $163.

You found treasure!
You gained $19! Woohoo!

>play ball
You gave the attendant $1.
You now have $181.

>look
Arcade
Inside this arcade you see a prize counter, some games, and a ball pit. You can use your money to play games and win tickets. The tickets can be used to get prizes at the prize counter.

You can see a prize counter (in which are a spinning top, a slinky, a rattle, a mini soccer game and crayons), a skeeball machine, a basketball hoop, a water gun game, a punching machine and a ball pit here.

>x top
You see nothing special about the spinning top.

* * *

>w
Arcade
Inside this arcade you see a prize counter, some games, and a ball pit. You can use your money to play games and win tickets. The tickets can be used to get prizes at the prize counter. There are exits in all directions to the Intersection.

You can see a prize counter (in which are a spinning top, a slinky, a rattle, a mini soccer game and crayons), a skeeball machine, a basketball hoop, a water gun game, a punching machine and a ball pit here.

>play ball pit
You put $1 into the machine.
You now have $99.

>play ball pit
You put $1 into the machine.
You now have $98.

You found treasure!
You gained $14! Woohoo!

* * *

>w
Arcade
Inside this arcade you see a prize counter, some games, and a ball pit. You can use your money to play games and win tickets. The tickets can be used to get prizes at the prize counter. There are exits in all directions to the Intersection.

You can see a prize counter (in which are a spinning top, a slinky, a rattle, a mini soccer game and crayons), a skeeball machine, a basketball hoop, a water gun game, a punching machine and a ball pit here.

>play hoop
You put $25 into the machine.
You now have $75.

You got 7 tickets.
You now have 7 tickets.

>play hoop
You put $25 into the machine.
You now have $50.

You got 6 tickets.
You now have 13 tickets.

>play hoop
You put $25 into the machine.
You now have $25.

You got 0 tickets.
You now have 13 tickets.

>play hoop
You put $25 into the machine.
You now have $0.

You got 1 tickets.
You now have 14 tickets.

>play hoop
You put $25 into the machine.
You now have $-25.

You got 7 tickets.
You now have 21 tickets.

>play hoop
You put $25 into the machine.
You now have $-50.

You got 10 tickets.
You now have 31 tickets.

>play hoop
You put $25 into the machine.
You now have $-75.

You got 3 tickets.
You now have 34 tickets.

>play hoop
You put $25 into the machine.
You now have $-100.

You got 3 tickets.
You now have 37 tickets.

>play hoop
You put $25 into the machine.
You now have $-125.

You got 1 tickets.
You now have 38 tickets.

>play hoop
You put $25 into the machine.
You now have $-150.

You got 5 tickets.
You now have 43 tickets.

>play hoop
You put $25 into the machine.
You now have $-175.

You got 6 tickets.
You now have 49 tickets.

>play hoop
You put $25 into the machine.
You now have $-200.

You got 3 tickets.
You now have 52 tickets.

>play hoop
You put $25 into the machine.
You now have $-225.

You got 14 tickets.
You now have 66 tickets.

>play hoop
You put $25 into the machine.
You now have $-250.

You got 14 tickets.
You now have 80 tickets.

>play hoop
You put $25 into the machine.
You now have $-275.

You got 14 tickets.
You now have 94 tickets.

>play hoop
You put $25 into the machine.
You now have $-300.

You got 0 tickets.
You now have 94 tickets.

* * *

>w
Arcade
Inside this arcade you see a prize counter, some games, and a ball pit. You can use your money to play games and win tickets. The tickets can be used to get prizes at the prize counter. There are exits in all directions to the Intersection.

You can see a prize counter (in which are a spinning top, a slinky, a rattle, a mini soccer game and crayons), a skeeball machine, a basketball hoop, a water gun game, a punching machine and a ball pit here.

>play in ball pit
I only understood you as far as wanting to play inside.

>play ball pit
You gave the attendant $1.
You now have $99.

>play ball pit
You gave the attendant $1.
You now have $98.

>play ball pit
You gave the attendant $1.
You now have $97.

>play ball pit
You gave the attendant $1.
You now have $96.

>play ball pit
You gave the attendant $1.
You now have $95.

You found treasure!
You gained $5! Woohoo!

>play ball pit
You gave the attendant $1.
You now have $99.

* * *

>play ball pit
You gave the attendant $1.
You now have $96.

>play ball pit
You gave the attendant $1.
You now have $95.

You found treasure!
You gained $20! Woohoo!

>play ball pit
You gave the attendant $1.
You now have $114.

>play ball pit
You gave the attendant $1.
You now have $113.

>play ball pit
You gave the attendant $1.
You now have $112.

>play ball pit
You gave the attendant $1.
You now have $111.

>play ball pit
You gave the attendant $1.
You now have $110.

You found treasure!
You gained $20! Woohoo!

>play ball pit
You gave the attendant $1.
You now have $129.

>play ball pit
You gave the attendant $1.
You now have $128.

>play ball pit
You gave the attendant $1.
You now have $127.

>play ball pit
You gave the attendant $1.
You now have $126.

>play ball pit
You gave the attendant $1.
You now have $125.

>play ball pit
You gave the attendant $1.
You now have $124.

>play ball pit
You gave the attendant $1.
You now have $123.

>play ball pit
You gave the attendant $1.
You now have $122.

You found treasure!
You gained $1! Woohoo!

>play ball pit
You gave the attendant $1.
You now have $122.

You found treasure!
You gained $9! Woohoo!

>play ball pit
You gave the attendant $1.
You now have $130.

>play ball pit
You gave the attendant $1.
You now have $129.

* * *

>play ball pit
You gave the attendant $1.
You now have $128.

>play ball pit
You gave the attendant $1.
You now have $127.

You found treasure!
You gained $20! Woohoo!

>play ball pit
You gave the attendant $1.
You now have $146.

>play ball pit
You gave the attendant $1.
You now have $145.

>play ball pit
You gave the attendant $1.
You now have $144.

>play ball pit
You gave the attendant $1.
You now have $143.

You found treasure!
You gained $12! Woohoo!

>play ball pit
You gave the attendant $1.
You now have $154.

>play ball pit
You gave the attendant $1.
You now have $153.

>play ball pit
You gave the attendant $1.
You now have $152.

>play ball pit
You gave the attendant $1.
You now have $151.

>play ball pit
You gave the attendant $1.
You now have $150.

>play ball pit
You gave the attendant $1.
You now have $149.

>play ball pit
You gave the attendant $1.
You now have $148.

>play ball pit
You gave the attendant $1.
You now have $147.

>play ball pit
You gave the attendant $1.
You now have $146.

You found treasure!
You gained $18! Woohoo!

>play ball pit
You gave the attendant $1.
You now have $163.

You found treasure!
You gained $8! Woohoo!

>play ball pit
You gave the attendant $1.
You now have $170.

>play ball pit
You gave the attendant $1.
You now have $169.

I beg your pardon?

>play ball pit
You gave the attendant $1.
You now have $168.

>play ball pit
You gave the attendant $1.
You now have $167.

>play ball pit
You gave the attendant $1.
You now have $166.

You found treasure!
You gained $3! Woohoo!

>play ball pit
You gave the attendant $1.
You now have $168.

>play ball pit
You gave the attendant $1.
You now have $167.

It's getting late, you should head home.

>play ball pit
You gave the attendant $1.
You now have $166.

You found treasure!
You gained $16! Woohoo!

It's getting late, you should head home.

>play ball pit
You gave the attendant $1.
You now have $181.

It's getting late, you should head home.

>play ball pit
You gave the attendant $1.
You now have $180.

It's getting late, you should head home.

>play ball pit
You gave the attendant $1.
You now have $179.

It's getting late, you should head home.

>play ball pit
You gave the attendant $1.
You now have $178.

It's getting late, you should head home.

>play hoop
You put $25 into the machine.
You now have $153.

You got 16 tickets.
You now have 0 tickets.

It's getting late, you should head home.

* * *

>w
Arcade
Inside this arcade you see a prize counter, some games, and a ball pit. You can use your money to play games and win tickets. The tickets can be used to get prizes at the prize counter. There are exits in all directions to the Intersection.

You can see a prize counter (in which are a spinning top, a slinky, a rattle, a mini soccer game and crayons), a skeeball machine, a basketball hoop, a water gun game, a punching machine and a ball pit here.

>play punch
You can't see any such thing.

>play punching
You put $5 into the machine.
You now have $95.

You got 4 tickets.
You now have 4 tickets.

>play punching
You put $5 into the machine.
You now have $90.

You got 3 tickets.
You now have 7 tickets.

>play punching
You put $5 into the machine.
You now have $85.

You got 5 tickets.
You now have 12 tickets.

>play punching
You put $5 into the machine.
You now have $80.

You got 7 tickets.
You now have 19 tickets.

>play punching
You put $5 into the machine.
You now have $75.

You got 1 tickets.
You now have 20 tickets.

>play punching
You put $5 into the machine.
You now have $70.

You got 7 tickets.
You now have 27 tickets.

>play punching
You put $5 into the machine.
You now have $65.

You got 5 tickets.
You now have 32 tickets.

>play punching
You put $5 into the machine.
You now have $60.

You got 3 tickets.
You now have 35 tickets.

>play punching
You put $5 into the machine.
You now have $55.

You got 0 tickets.
You now have 35 tickets.

>play punching
You put $5 into the machine.
You now have $50.

You got 4 tickets.
You now have 39 tickets.

>play punching
You put $5 into the machine.
You now have $45.

You got 5 tickets.
You now have 44 tickets.

>play punching
You put $5 into the machine.
You now have $40.

You got 2 tickets.
You now have 46 tickets.

>play punching
You put $5 into the machine.
You now have $35.

You got 3 tickets.
You now have 49 tickets.

>play punching
You put $5 into the machine.
You now have $30.

You got 5 tickets.
You now have 54 tickets.

>play punching
You put $5 into the machine.
You now have $25.

You got 3 tickets.
You now have 57 tickets.

>play punching
You put $5 into the machine.
You now have $20.

You got 6 tickets.
You now have 63 tickets.

>play punching
You put $5 into the machine.
You now have $15.

You got 5 tickets.
You now have 68 tickets.

>play punching
You put $5 into the machine.
You now have $10.

You got 1 tickets.
You now have 69 tickets.

>play punching
You put $5 into the machine.
You now have $5.

You got 0 tickets.
You now have 69 tickets.

>play punching
You put $5 into the machine.
You now have $0.

You got 2 tickets.
You now have 71 tickets.

>play punching
You put $5 into the machine.
You now have $-5.

You won the jackpot!
You got 15 tickets.
You now have 86 tickets.

>look
Arcade
Inside this arcade you see a prize counter, some games, and a ball pit. You can use your money to play games and win tickets. The tickets can be used to get prizes at the prize counter.

You can see a prize counter (in which are a spinning top, a slinky, a rattle, a mini soccer game and crayons), a skeeball machine, a basketball hoop, a water gun game, a punching machine and a ball pit here.

>play counter
You can only play with arcade machines.

>take slinky
You put the slinky in your pockets.

>take hoop
That's fixed in place.

* * *

>w
Arcade
Inside this arcade you see a prize counter, some games, and a ball pit. You can use your money to play games and win tickets. The tickets can be used to get prizes at the prize counter. There are exits in all directions to the Intersection.

You can see a prize counter (in which are a spinning top, a slinky, a rattle, a mini soccer game and crayons), a skeeball machine, a basketball hoop, a water gun game, a punching machine and a ball pit here.

>take crayong
You can't see any such thing.

>take crayons
You do not have enough tickets for crayons.

>play punching
You put $5 into the machine.
You now have $95.

You got 3 tickets.
You now have 3 tickets.

>play punching
You put $5 into the machine.
You now have $90.

You got 1 tickets.
You now have 4 tickets.

>play punching
You put $5 into the machine.
You now have $85.

You got 4 tickets.
You now have 8 tickets.

>play punching
You put $5 into the machine.
You now have $80.

You got 0 tickets.
You now have 8 tickets.

>play punching
You put $5 into the machine.
You now have $75.

You got 2 tickets.
You now have 10 tickets.

>take crayons
You traded 10 tickets for it.
You put crayons in your pockets.

* * *

>w
Arcade
Inside this arcade you see a prize counter, some games, and a ball pit. You can use your money to play games and win tickets. The tickets can be used to get prizes at the prize counter. There are exits in all directions to the Intersection.

You can see a prize counter (in which are a spinning top, a slinky, a rattle, a mini soccer game and crayons), a skeeball machine, a basketball hoop, a water gun game, a punching machine and a ball pit here.

>take crayons
You do not have enough tickets for crayons.

>x crayons
A pack of 8 crayons. It has all the colors you might need... and white. It has the lowest exchange price of 10 tickets!

You need 10 tickets to trade for it.

>x top
A simple neon yellow spinning top. It is small enough to swallow. You can trade in 40 tickets for it.

You need 40 tickets to trade for it.

>play hoop
You put $25 into the machine.
You now have $75.

You got 9 tickets.
You now have 9 tickets.

>play hoop
You put $25 into the machine.
You now have $50.

You got 12 tickets.
You now have 21 tickets.

>play hoop
You put $25 into the machine.
You now have $25.

You got 1 tickets.
You now have 22 tickets.

>play hoop
You put $25 into the machine.
You now have $0.

You got 14 tickets.
You now have 36 tickets.

>play hoop
You put $25 into the machine.
You now have $-25.

You got 0 tickets.
You now have 36 tickets.

>play hoop
You put $25 into the machine.
You now have $-50.

You got 2 tickets.
You now have 38 tickets.

>play hoop
You put $25 into the machine.
You now have $-75.

You got 4 tickets.
You now have 42 tickets.

>trade for top
That's not a verb I recognise.

>take top
You traded 40 tickets for the spinning top.
You put the spinning top in your pockets.

>x top
A simple neon yellow spinning top. It is small enough to swallow. You can trade in 0 tickets for it.

* * *

>w
Arcade
Inside this arcade you see a prize counter, some games, and a ball pit. You can use your money to play games and win tickets. The tickets can be used to get prizes at the prize counter. There are exits in all directions to the Intersection.

You can see a prize counter (in which are a spinning top, a slinky, a rattle, a mini soccer game and crayons), a skeeball machine, a basketball hoop, a water gun game, a punching machine and a ball pit here.

>take slinky
You traded 75 tickets for it.
You put the slinky in your pockets.

>x self
Your balance is $100 and you have -75 tickets.

* * *

>w
Arcade
Inside this arcade you see a prize counter, some games, and a ball pit. You can use your money to play games and win tickets. The tickets can be used to get prizes at the prize counter. There are exits in all directions to the Intersection.

You can see a prize counter (in which are a spinning top, a slinky, a rattle, a mini soccer game and crayons), a skeeball machine, a basketball hoop, a water gun game, a punching machine and a ball pit here.

>x hoop
You used to play basketball in school, maybe your skills will come back to you. The balls are slightly smaller than regular and deflated a bit. This potential payout is only up to 30 tickets but its really fun

It costs $25 to play.

>play basketball
You put $25 into the machine.
You now have $75.

You won the jackpot!
You got 30 tickets.
You now have 30 tickets.

>play basketball
You put $25 into the machine.
You now have $50.

You got 30 tickets.
You now have 30 tickets.

>play basketball
You put $25 into the machine.
You now have $25.

You got 30 tickets.
You now have 30 tickets.

>play basketball
You put $25 into the machine.
You now have $0.

You won the jackpot!
You got 30 tickets.
You now have 60 tickets.

>play basketball
You put $25 into the machine.
You now have $-25.

You got 30 tickets.
You now have 60 tickets.

>turn
What do you want to turn?

>basketball
It is fixed in place.

>look
Arcade
You can see a skeeball machine, a basketball hoop, a water gun game and a punching machine here.

* * *

>w
Arcade
Inside this arcade you see a prize counter, some games, and a ball pit. You can use your money to play games and win tickets. The tickets can be used to get prizes at the prize counter. There are exits in all directions to the Intersection.

You can see a prize counter (in which are a spinning top, a slinky, a rattle, a mini soccer game and crayons), a skeeball machine, a basketball hoop, a water gun game, a punching machine and a ball pit here.

>x machine
A game of skill, potential to gain upwards of 100 tickets. You are not very skilled. 

It costs $20 to play.

>take machine
That's fixed in place.

>play machine
That's not a verb I recognise.

>use plachine
That's not a verb I recognise.

>interact with machine
That's not a verb I recognise.

* * *

>w
Arcade
Inside this arcade you see a prize counter, some games, and a ball pit. You can use your money to play games and win tickets. The tickets can be used to get prizes at the prize counter. There are exits in all directions to the Intersection.

You can see a prize counter (in which are a spinning top, a slinky, a rattle, a mini soccer game and crayons), a skeeball machine, a basketball hoop, a water gun game, a punching machine and a ball pit here.

>x skee
You can't see any such thing.

>x machine
A game of skill, potential to gain upwards of 100 tickets. You are not very skilled. Costs $20 to play.

It is priced at $20.

* * *

>w
Arcade
Inside this arcade you see a prize counter, some games, and a ball pit. You can use your money to play games and win tickets. The tickets can be used to get prizes at the prize counter. There are exits in all directions to the Intersection.

You can see a prize counter (in which are a spinning top, a slinky, a rattle, a mini soccer game and crayons), a skeeball machine, a basketball hoop, a water gun game, a punching machine and a ball pit here.

>x skeeball
A game of skill, potential to gain upwards of 100 tickets. You are not very skilled.

It costs $20 to play.

>play skeebal
You can't see any such thing.

>play skeeball
You input $20 into the machine.
You now have $80.

>play skeeball
You input $20 into the machine.
You now have $60.

>play skeeball
You input $20 into the machine.
You now have $40.

>play skeeball
You input $20 into the machine.
You now have $20.

>play skeeball
You input $20 into the machine.
You now have $0.

>play skeeball
You input $20 into the machine.
You now have $-20.

>play skeeball
You input $20 into the machine.
You now have $-40.

You won the jackpot!

>play skeeball
You input $20 into the machine.
You now have $-60.

>play basketball
You can only play with arcade machines.

* * *

>w
Arcade
Inside this arcade you see a prize counter, some games, and a ball pit. You can use your money to play games and win tickets. The tickets can be used to get prizes at the prize counter. There are exits in all directions to the Intersection.

You can see a prize counter (in which are a spinning top, a slinky, a rattle, a mini soccer game and crayons), a skeeball machine, a basketball hoop, a water gun game, a punching machine and a ball pit here.

>x top
A simple neon yellow spinning top. It is small enough to swallow. You can trade in 40 tickets for it.

>buy top
Nothing is on sale.

>play machine
Which do you mean, the skeeball machine or the punching machine?

>skeeball
You put $20 into the machine.
You now have $80.

You got 47 tickets.
You now have 47 tickets.

>x skeeball
A game of skill, potential to gain upwards of 100 tickets. You are not very skilled.

It costs $20 to play.

>x water gun game
A classic carvnival game where you aim at the target with your water gun and try to make the lights go all the way up. The potential payout is 20 tickets.

It costs $10 to play.

>x ball pit
It is filthy. It probably has not been cleaned in months. You can't gain tickets, but maybe there is hidden treasure here!

It costs $1 to play.

>play ball pit
You gave the attendant $1.
You now have $79.

I beg your pardon?

>play ball pit
You gave the attendant $1.
You now have $78.

>play ball pit
You gave the attendant $1.
You now have $77.

>play ball pit
You gave the attendant $1.
You now have $76.

>play ball pit
You gave the attendant $1.
You now have $75.

>play ball pit
You gave the attendant $1.
You now have $74.

>play ball pit
You gave the attendant $1.
You now have $73.

>play ball pit
You gave the attendant $1.
You now have $72.

>play ball pit
You gave the attendant $1.
You now have $71.

>play ball pit
You gave the attendant $1.
You now have $70.

You found treasure!
You gained $1! Woohoo!

>play ball pit
You gave the attendant $1.
You now have $70.

>play ball pit
You gave the attendant $1.
You now have $69.

You found treasure!
You gained $15! Woohoo!

>play ball pit
You gave the attendant $1.
You now have $83.

>play ball pit
You gave the attendant $1.
You now have $82.

>play ball pit
You gave the attendant $1.
You now have $81.

>play ball pit
You gave the attendant $1.
You now have $80.

>play ball pit
You gave the attendant $1.
You now have $79.

>play ball pit
You gave the attendant $1.
You now have $78.

>play ball pit
You gave the attendant $1.
You now have $77.

You found treasure!
You gained $12! Woohoo!

>look
Arcade
Inside this arcade you see a prize counter, some games, and a ball pit. You can use your money to play games and win tickets. The tickets can be used to get prizes at the prize counter. There are exits in all directions to the Intersection.

You can see a prize counter (in which are a spinning top, a slinky, a rattle, a mini soccer game and crayons), a skeeball machine, a basketball hoop, a water gun game, a punching machine and a ball pit here.

>x punching
Test your strength with this machine. The potential payout is 15 tickets.

It costs $5 to play.

>x game
(the water gun game)
A classic carvnival game where you aim at the target with your water gun and try to make the lights go all the way up. The potential payout is 20 tickets.

It costs $10 to play.

>x hoop
You used to play basketball in school, maybe your skills will come back to you. The balls are slightly smaller than regular and deflated a bit. This potential payout is only up to 30 tickets but its really fun

It costs $25 to play.

>x skeeball
A game of skill, potential to gain upwards of 100 tickets. You are not very skilled.

It costs $20 to play.

>play skeeball
You put $20 into the machine.
You now have $69.

You got 31 tickets.
You now have 78 tickets.

>take top
You traded 40 tickets for the spinning top.
You put the spinning top in your pockets.

>x top
A simple neon yellow spinning top. It is small enough to swallow.

>out
The Intersection
There is an Arcade to the west, a large Gas Station to the east and the Car in the Intersection.

* * *

>in
Car
A beat up red sedan with no headlights, just stickers. Outside is a busy intersection.

You can see a Baby and a diaper bag (in which are diapers, a bottle, old fruit snacks and rash cream) here.

>give top to baby
The Baby doesn't seem interested.

* * *

>out
The Intersection
There is an Arcade to the west, a large Gas Station to the east and the Car in the Intersection.

>x arcade
You can't see any such thing.

>look
The Intersection
There is an Arcade to the west, a large Gas Station to the east and the Car in the Intersection.

>e
Gas Station
It's empty. There are no cars. Just a Food Stand to the North and the Convenience Store to the East.

>n
Food Stand

* * *

Lab1
An Interactive Fiction by Ozcar Cayetano
Release 1 / Serial number 260408 / Inform 7 v10.1.2 / D

You are rushing down Washington Avenue, in your small car, because the Baby in the backseat is hysterically crying. You do not know what it wants but you decide to pull over at a busy intersection to try and make the rest of the 4 hour drive home barable.

Car
A beat up red sedan with no headlights, just stickers. Outside is a busy intersection.

You can see a Baby and a diaper bag (in which are diapers, a bottle, old fruit snacks and rash cream) here.

>outside
The Intersection

>inside
Car
A beat up red sedan with no headlights, just stickers.

You can see a Baby and a diaper bag (in which are diapers, a bottle, old fruit snacks and rash cream) here.

>outisde
That's not a verb I recognise.

>outside
The Intersection

>west
Arcade

>w
You can't go that way.

>inside
You can't go that way.

* * *

>inside
Car
A beat up red sedan with no headlights, just stickers.

You can see a Baby and a diaper bag (in which are diapers, a bottle, old fruit snacks and rash cream) here.

>outside
The Intersection

>w
Arcade

>e
You can't go that way.

>go to Intersection
You can't see any such thing.

* * *

Lab1
An Interactive Fiction by Ozcar Cayetano
Release 1 / Serial number 260408 / Inform 7 v10.1.2 / D

You are rushing down Washington Avenue, in your small car, because the Baby in the backseat is hysterically crying. You do not know what it wants but you decide to pull over at a busy intersection to try and make the rest of the 4 hour drive home barable.

Car
A beat up red sedan with no headlights, just stickers. Outside is a busy intersection.

You can see a Baby and a diaper bag (in which are diapers, a bottle, old fruit snacks and rash cream) here.

>t bottle
That's not a verb I recognise.

* * *

Lab1
An Interactive Fiction by Ozcar Cayetano
Release 1 / Serial number 260408 / Inform 7 v10.1.2 / D

You are rushing down Washington Avenue, in your small car, because the Baby in the backseat is hysterically crying. You do not know what it wants but you decide to pull over at a busy intersection to try and make the rest of the 4 hour drive home barable.

Car
A beat up red sedan with no headlights, just stickers. Outside is a busy intersection.

You can see a Baby and a diaper bag (in which are diapers, a bottle, old fruit snacks and rash cream) here.

>take baby
It's only going to slow you down, leave it here.

>look
Car
A beat up red sedan with no headlights, just stickers.

You can see a Baby and a diaper bag (in which are diapers, a bottle, old fruit snacks and rash cream) here.

>examine car
You can't see any such thing.

>look
Car
A beat up red sedan with no headlights, just stickers.

You can see a Baby and a diaper bag (in which are diapers, a bottle, old fruit snacks and rash cream) here.

>take cream
Taken.

>look
Car
A beat up red sedan with no headlights, just stickers.

You can see a Baby and a diaper bag (in which are diapers, a bottle and old fruit snacks) here.

>take rash creawm
I only understood you as far as wanting to take rash cream.

>take rash cream
You already have that.

* * *

>take baby
It's only going to slow you down, leave it here.

>take
What do you want to take?

>baby
It's only going to slow you down, leave it here.

>baby
That's not a verb I recognise.

>clear
What do you want to clear?

>text
You can't see any such thing.

>i
You are carrying nothing.

>take bottle
You put the bottle in your pockets.

>give bottle to baby
The Baby doesn't seem interested.

>SHOWME baby
Baby - person
location: in the Car
unlit, inedible, portable; transparent, male; singular-named, improper-named
description: "The Baby is drooling all over it's yellow-orange bib and swirling its hair into a spiral."
initial appearance: none
carrying capacity: 100
printed name: "Baby"
printed plural name: "people"
indefinite article: none
list grouping key: none

* * *

>take baby
It's only going to slow you down, leave it here.

>take bag
The bag should stay with the baby.

>take diapers
Taken.

>use diapers on baby
That's not a verb I recognise.

>drop diapers in bag
You put diapers into the diaper bag.

* * *

Lab1
An Interactive Fiction by Ozcar Cayetano
Release 1 / Serial number 260408 / Inform 7 v10.1.2 / D

You are rushing down Washington Avenue, in your small car, because the Baby in the backseat is hysterically crying. You do not know what it wants but you decide to pull over at a busy intersection to try and make the rest of the 4 hour drive home barable.

Car
A beat up red sedan with no headlights, just stickers. Outside is a busy intersection.

You can see a Baby and a diaper bag (in which are diapers, a bottle, old fruit snacks and rash cream) here.

>take bag
The bag stays with the baby.

>take diaper bag
The bag stays with the baby.

* * *

Lab1
An Interactive Fiction by Ozcar Cayetano
Release 1 / Serial number 260408 / Inform 7 v10.1.2 / D

You are rushing down Washington Avenue, in your small car, because the Baby in the backseat is hysterically crying. You do not know what it wants but you decide to pull over at a busy intersection to try and make the rest of the 4 hour drive home barable.

Car
A beat up red sedan with no headlights, just stickers. Outside is a busy intersection.

You can see a Baby and a diaper bag (in which are diapers, a bottle, old fruit snacks and rash cream) here.

>take bottle
You put the bottle in your pockets.

>drop bottle
Dropped.

>take bottle
You put the bottle in your pockets.

>out
The Intersection
There is an Arcade to the west, a large Gas Station to the east and the Car in the Intersection.

* * *

>e
Convenience Store
The cashier seems occupied with someone on the phone. The actual store only has one shelf of snacks. To the west is the Gas Station.

You can see a snack shelf (in which are a bag of potato chips, a candy bar, an orange soda and milk) here.

>take potato chips
You paid 4.
You put the bag of potato chips in your pockets.

>drop potato chips
Dropped.

>take potato chips
You put the bag of potato chips in your pockets.

>take candy
You paid 2.
You put the candy bar in your pockets.

>take soda
You paid 3.
You put the orange soda in your pockets.

>take milk
You paid 5.
You put milk in your pockets.

>x soda
You see nothing special about the orange soda.

* * *

>take bottle
You put the bottle in your pockets.

>i
You are carrying:
  a bottle

>out
The Intersection
There is an Arcade to the west, a large Gas Station to the east and the Car in the Intersection.

* * *

>e
Gas Station
It's empty. There are no cars. Just a Food Stand to the North and the Convenience Store to the East.

>e
Convenience Store
The cashier seems occupied with someone on the phone. The actual store only has one shelf of snacks. To the west is the Gas Station.

You can see a snack shelf (in which are a bag of potato chips, a candy bar, a room temperature orange soda and refrigerated milk) here.

>take chips
You paid 3.

>x self
Your balance is $97.

* * *

Lab1
An Interactive Fiction by Ozcar Cayetano
Release 1 / Serial number 260408 / Inform 7 v10.1.2 / D

You are rushing down Washington Avenue, in your small car, because the Baby in the backseat is hysterically crying. You do not know what it wants but you decide to pull over at a busy intersection to try and make the rest of the 4 hour drive home barable.

Car
A beat up red sedan with no headlights, just stickers. Outside is a busy intersection.

You can see a Baby and a diaper bag (in which are diapers, a bottle, old fruit snacks and rash cream) here.

>take diaper
The bag should stay with the baby.

>out
The Intersection
There is an Arcade to the west, a large Gas Station to the east and the Car in the Intersection.

* * *

>e
Convenience Store
The cashier seems occupied with someone on the phone. The actual store only has one shelf of snacks. To the west is the Gas Station.

You can see a snack shelf (in which are a bag of potato chips, a candy bar, a room temperature orange soda and refrigerated milk) here.

>take milk
*** Run-time problem P10: Since refrigerated milk is not allowed the property "price", it is against the rules to try to use it.

* * *

Lab1
An Interactive Fiction by Ozcar Cayetano
Release 1 / Serial number 260408 / Inform 7 v10.1.2 / D

You are rushing down Washington Avenue, in your small car, because the Baby in the backseat is hysterically crying. You do not know what it wants but you decide to pull over at a busy intersection to try and make the rest of the 4 hour drive home barable.

Car
A beat up red sedan with no headlights, just stickers. Outside is a busy intersection.

You can see a Baby and a diaper bag (in which are diapers, a bottle, old fruit snacks and rash cream) here.

>take diaper bag
The bag should stay with the baby.

>i
You are carrying:
  a diaper bag
    diapers
    a bottle
    old fruit snacks
    rash cream

* * *

>take diaper bag
The bag should stay with the baby.

>out
The Intersection
There is an Arcade to the west, a large Gas Station to the east and the Car in the Intersection.

>w
Arcade
Inside this arcade you see a prize counter, some games, and a ball pit. You can use your money to play games and win tickets. The tickets can be used to get prizes at the prize counter.

You can see a prize counter (in which are a spinning top, a slinky, a rattle, a mini soccer game and crayons), a skeeball machine, a basketball hoop, a water gun game, a punching machine and a ball pit here.

>take top
You do not have enough tickets for the spinning top.

>i
You are carrying nothing.

>take machine
Which do you mean, the skeeball machine or the punching machine?

>skeeball
That's fixed in place.

>e
The Intersection
There is an Arcade to the west, a large Gas Station to the east and the Car in the Intersection.

* * *

Lab1
An Interactive Fiction by Ozcar Cayetano
Release 1 / Serial number 260408 / Inform 7 v10.1.2 / D

You are rushing down Washington Avenue, in your small car, because the Baby in the backseat is hysterically crying. You do not know what it wants but you decide to pull over at a busy intersection to try and make the rest of the 4 hour drive home barable.

Car
A beat up red sedan with no headlights, just stickers. Outside is a busy intersection.

You can see a Baby and a diaper bag (in which are diapers, a bottle, old fruit snacks and rash cream) here.

>take diapers
You put diapers in your pockets.

>look
Car
A beat up red sedan with no headlights, just stickers.

You can see a Baby and a diaper bag (in which are a bottle, old fruit snacks and rash cream) here.

>take rash cream
Taken.

>look
Car
A beat up red sedan with no headlights, just stickers.

You can see a Baby and a diaper bag (in which are a bottle and old fruit snacks) here.

>take bottle
Taken.

>take fruit snacks
Taken.

>look
Car
A beat up red sedan with no headlights, just stickers.

You can see a Baby and a diaper bag (empty) here.

* * *

>take diapers
You put diapers in your pockets.

>take bottle
You put the bottle in your pockets.

>take fruit snacks
You put old fruit snacks in your pockets.

>take rash cream
That's not gonna help the baby. You have that incase you get that strange rash that prevents you from sitting properly again.

>out
The Intersection
There is an Arcade to the west, a large Gas Station to the east and the Car in the Intersection.

* * *

>w
Arcade
Inside this arcade you see a prize counter, some games, and a ball pit. You can use your money to play games and win tickets. The tickets can be used to get prizes at the prize counter.

You can see a prize counter (in which are a spinning top, a slinky, a rattle, a mini soccer game and crayons), a skeeball machine, a basketball hoop, a water gun game, a punching machine and a ball pit here.

>take top
You do not have enough tickets for the spinning top.

You traded 40 tickets for it.
You put the spinning top in your pockets.

>i
You are carrying:
  a spinning top
  old fruit snacks
  a bottle
  diapers

* * *

Lab1
An Interactive Fiction by Ozcar Cayetano
Release 1 / Serial number 260408 / Inform 7 v10.1.2 / D

You are rushing down Washington Avenue, in your small car, because the Baby in the backseat is hysterically crying. You do not know what it wants but you decide to pull over at a busy intersection to try and make the rest of the 4 hour drive home barable.

Car
A beat up red sedan with no headlights, just stickers. Outside is a busy intersection.

You can see a Baby and a diaper bag (in which are diapers, a bottle, old fruit snacks and rash cream) here.

>take rash cream
That's not gonna help the baby. I have that incase I get that strange rash prevents me from sitting properly again.

>i
You are carrying nothing.

* * *

Lab1
An Interactive Fiction by Ozcar Cayetano
Release 1 / Serial number 260408 / Inform 7 v10.1.2 / D

You are rushing down Washington Avenue, in your small car, because the Baby in the backseat is hysterically crying. You do not know what it wants but you decide to pull over at a busy intersection to try and make the rest of the 4 hour drive home barable.

Car
A beat up red sedan with no headlights, just stickers. Outside is a busy intersection.

You can see a Baby and a diaper bag (in which are diapers, a bottle, old fruit snacks and rash cream) here.

>take snacks
You put old fruit snacks in your pockets.

* * *

>e
Convenience Store
The cashier seems occupied with someone on the phone. The actual store only has one shelf of snacks. To the west is the Gas Station.

You can see a snack shelf (in which are a bag of potato chips, a candy bar, an orange soda and milk) here.

>x bar
A hefty chocolate flavored candy bar.

It is priced at $2.

>x milk
A full gallon of whole milk. It is cold to the touch even though it is on the shelf, weird.

It is priced at $5.

>x soda
A fizzy, radioactive orange drink. It is room temperature... 

It is priced at $3.

>x chips
There is an excessive sodium and calorie warning on the front. Barbeque flavored, yum!

It is priced at $4.

>take drink
You can't see any such thing.

>take soda
You paid $3.
You put the orange soda in your pockets.

>i
You are carrying:
  an orange soda
  old fruit snacks

>clear
What do you want to clear?

>drop soda
Dropped.

>x soda
A fizzy, radioactive orange drink. It is room temperature...

>take soda
You put the orange soda in your pockets.

>clear
What do you want to clear?

* * *

>take snacks
You put old fruit snacks in your pockets.

>take rash cream
That's not gonna help the baby. You have that incase you get that strange rash that prevents you from sitting properly again.

* * *

>take chips
You paid $4.
You put the bag of potato chips in your pockets.

>x bar
A hefty chocolate flavored candy bar. It is priced at $2, what a bargain!

>take bar
You paid $2.
You put the candy bar in your pockets.

>x soda
A fizzy, radioactive orange drink. It is room temperature... It is priced at $3.

>x shelf
The small shelf has a variety of snacks.

In the snack shelf are an orange soda and milk.

>x milk
You see nothing special about milk.

* * *

Lab1
An Interactive Fiction by Ozcar Cayetano
Release 1 / Serial number 260408 / Inform 7 v10.1.2 / D

You are rushing down Washington Avenue, in your small car, because the Baby in the backseat is hysterically crying. You do not know what it wants but you decide to pull over at a busy intersection to try and make the rest of the 4 hour drive home barable.

Car
A beat up red sedan with no headlights, just stickers. Outside is a busy intersection.

You can see a Baby and a diaper bag (in which are diapers, a bottle, old fruit snacks and rash cream) here.

>w
You can't go that way.

>outside
The Intersection

* * *

>w
Arcade

>e
The Intersection

>w
Arcade

>w
You can't go that way.

>n
You can't go that way.

>s
You can't go that way.

>nw
You can't go that way.

>e
The Intersection

>look
The Intersection

* * *

Lab1
An Interactive Fiction by Ozcar Cayetano
Release 1 / Serial number 260408 / Inform 7 v10.1.2 / D

You are rushing down Washington Avenue, in your small car, because the Baby in the backseat is hysterically crying. You do not know what it wants but you decide to pull over at a busy intersection to try and make the rest of the 4 hour drive home barable.

Car
A beat up red sedan with no headlights, just stickers. Outside is a busy intersection.

You can see a Baby and a diaper bag (in which are diapers, a bottle, old fruit snacks and rash cream) here.

>x car
You can't see any such thing.

>x car
You can't see any such thing.

>look
Car
A beat up red sedan with no headlights, just stickers.

You can see a Baby and a diaper bag (in which are diapers, a bottle, old fruit snacks and rash cream) here.

* * *

Lab1
An Interactive Fiction by Ozcar Cayetano
Release 1 / Serial number 260408 / Inform 7 v10.1.2 / D

You are rushing down Washington Avenue, in your small car, because the Baby in the backseat is hysterically crying. You do not know what it wants but you decide to pull over at a busy intersection to try and make the rest of the 4 hour drive home barable.

Car
A beat up red sedan with no headlights, just stickers. Outside is a busy intersection.

You can see a Baby and a diaper bag (in which are diapers, a bottle, old fruit snacks and rash cream) here.

>x self
Your balance is $100.

>SHOWME baby
Baby - person
location: in the Car
unlit, inedible, portable; transparent, male; singular-named, improper-named
description: "The Baby is drooling all over it's yellow-orange bib and swirling its hair into a spiral."
initial appearance: none
carrying capacity: 100
printed name: "Baby"
printed plural name: "people"
indefinite article: none
list grouping key: none

* * *

>x self
Your balance is $100.

>SHOWME self
yourself - person
location: in the Car
unlit, inedible, portable; transparent, male; singular-named, proper-named
description: "As good-looking as ever."
initial appearance: none
carrying capacity: 100
printed name: "yourself"
printed plural name: "people"
indefinite article: none
list grouping key: none
balance: 100

* * *

>x self
Your balance is $100.

>look
Car
You can see a diaper bag (empty) here.

>clear
(the diaper bag)
Nothing obvious happens.

* * *

>x self
Your balance is $100.

>out
The Intersection
There is an Arcade to the west, a large Gas Station to the east and the Car in the Intersection.

>w
Arcade
You can see a skeeball machine here.

>x self
Your balance is 100.

>x self
Your balance is 100.

>e
The Intersection
There is an Arcade to the west, a large Gas Station to the east and the Car in the Intersection.

>w
Arcade
You can see a skeeball machine here.

* * *

>x self
Your balance is $100.

>w
You can't go that way.

>out
The Intersection
There is an Arcade to the west, a large Gas Station to the east and the Car in the Intersection.

* * *

>w
Arcade
You can see a skeeball machine here.

>x
(the skeeball machine)
A game of skill, potential to gain upwards of 100 tickets. You are not very skilled. Costs $3 to play.

>x self
Your balance is 100 and you have 0 tickets.